#################################################################################################################################################################################
#################################################################################################################################################################################
#################################################################################################################################################################################
#################################################################################################################################################################################
#################################################################################################################################################################################
#################################################################################################################################################################################
#################################################################################################################################################################################
#################################################################################################################################################################################
#################################################################################################################################################################################
#####################.........................................................................................................................................###################
#####################...........................................................................###...........................................@...............###################
#####################.............................................................................#...........................................#...#......A....###################
#####################.............................................................................#........#...###....#...#........#...#...............##########################
#####################.............................................................................#............................#..............................###################
#####################...................................................................................#.....................................................###################
#####################.........................................................................................................................................###################
#####################................................................................................#........................................................###################
#####################.......................................................................................#.................................................###################
#####################.............................................................................#...##......................................................###################
#####################...................................................................#....##...............................................................###################
#####################..............................................................##.........................................................................###################
#####################.......................................................##................................................................................###################
####################################################################.....########################################################################################################
#####################................................................#........................................................................................###################
#####################....................................###.....#####........................................................................................###################
#####################..............................#..........................................................................................................###################
#####################.....................####...........................................###..................................................................###################
#####################....................................................................#....................................................................###################
#####################..............##....#...............................................###..................................................................###################
#####################........................##..........................................#.#..................................................................###################
#####################.............................#....##...#............................###..................................................................###################
#####################............................................#............................................................................................###################
#####################..................................................##.................................###...##............................................###################
#####################........................................................#....##....#............#...............#####....................................###################
#####################........................................................................##...................................###.........................###################
#####################.........................................................................................................................................###################
#############################################################################################################################################....################################
#####################..........................................................................................................................#..............###################
#####################.................................................................................................................########................###################
#####################................................................................................................................#........................###################
#####################.............................................................................................................#...........................###################
#####################......................................................................................................###................................###################
#####################....................................................................................................#....................................###################
#####################................................................................................................#.........###............................###################
#####################..........................................................................#..................#............#..............................###################
#####################........................................................................#.......#..........#...............#.............................###################
#####################...................................................................#..................#...................###............................###################
#####################..............................................................##.........................................................................###################
#####################.........................................................#...............................................................................###################
#####################....................................................#....................................................................................###################
###################################......##################........################.....##############.......##############......#####....#######......##########################
#####################...........................##..............#.............................................................................................###################
#####################........................................#................................................................................................###################
#####################.............##.....#....##........#............#.#......................................................................................###################
#####################........##......................................###......................................................................................###################
#####################..............##..................................#......................................................................................###################
#####################.....................##..................................................................................................................###################
#####################.............................#...........................................................................................................###################
#####################..................................##..##.................................................................................................###################
#####################..........................................##.............................................................................................###################
#####################.................................................##.....#......####.....###..............................................................###################
#####################.............................................................................##..........................................................###################
#####################....................................................................................#....................................................###################
#####################..........................................................................................##.............................................###################
##################################......##############.....#########....##########.......############.....#############.....#####################################################
#####################................................................................................................###......................................###################
#####################..................................................................................#.....##...............................................###################
#####################................................................#.........#....##.....##....##...........................................................###################
#####################.......................................#...##........##..................................................................................###################
#####################...............................#...##....................................................................................................###################
#####################..........................##.............................................................................................................###################
#####################..................##.............###.....................................................................................................###################
#####################...........#.......................#.....................................................................................................###################
#####################..................................##.....................................................................................................###################
#####################........#..........................#.....................................................................................................###################
#####################............##...................###.....................................................................................................###################
#####################.................#.......................................................................................................................###################
#####################.....................#...................................................................................................................###################
#######################################################################......################################........################..##########################################
#####################..................................................##.....................................................................................###################
#####################.......................................................#..#.................................#............................................###################
#####################..............................................................#..##.........#.......#...##......#........................................###################
#####################......................................................................###.......#.....................#..................................###################
#####################..........................................................................................................#..............................###################
#####################...........................................................................................###................#..........................###################
#####################.............................................................................................#......................#....................###################
#####################............................................................................................#.............................####...........###################
#####################...........................................................................................#..........................#..................###################
#####################...........................................................................................###..................#........................###################
#####################...........................................................................................................#.............................###################
#####################......................................................................................................#..................................###################
#####################.........................................................................................................................................###################
################################################...####################...#########################....############################.....#########################################
#####################...............................................................................................................#.........................###################
#####################....................................................................................................#......##..###.......#...............###################
#####################.............................................................................................#..................................#........###################
#####################............................#..........#...........#...................................#.........#...........#.............##............###################
#####################....................#.......................................#.....................#.........................##........#..................###################
#########################........#......................................................#####.....................................#............#..............###################
#####################............................................................................................................###..............###.........###################
#####################.......................................................................................................................#.................###################
#####################...............#..............####...................................................................................#...................###################
#####################..............................................................................................................#....##....................###################
#####################..........#...............................................................................................#.............................####################
#####################...........................................................................................######....#...................................###################
#####################.......................................................................................#.................................................###################
#################################################################################################################################################################################
#################################################################################################################################################################################
#################################################################################################################################################################################
#################################################################################################################################################################################
#################################################################################################################################################################################
#################################################################################################################################################################################
#################################################################################################################################################################################
#################################################################################################################################################################################
#################################################################################################################################################################################
#################################################################################################################################################################################
#################################################################################################################################################################################
