################################
#..............................#
#..............................#
#..............................#
#...##.........................#
#.................##...........#
#..............................#
#............@.................#
#..............................#
#..............................#
#..............................#
#..............................#
#..............................#
#..............................#
################################
################################
